##########
#S        
#  @###   
#     #   
#  E  #   
##########