# # # # # # # # # # #
# #                 #
# # #       #       #
#               # # #
#     E             #
#       #           #
#     #   #         #
#     #         #   #
# #     #   #   S   #
# # #       #       #
#                   #
# # # # # # # # # # #