#  ##  ####  ##
#S            #
#  ####   ##  #
#  #  ###  #  #
   #  #E#  #  #
#  #### ###  # 
#            # 