# # # # # # # #
#         #   #
#   #          
#   S #       #
# # # E ###   #
#              
# # # #   # # #